1111111111111
100100000C001
10E0110000001
100000000P001
1111111111111

