1111111111111
1000000000001
100100000C001
1000011111001
10E0110000P01
1000000000001
1111111111111
